1.388888888888888951e-01
1.944444444444444475e-01
2.685185185185185452e-01
1.944444444444444475e-01
2.129629629629629650e-01
2.592592592592592449e-01
1.111111111111111049e-01
2.222222222222222099e-01
2.407407407407407274e-01
1.296296296296296224e-01
1.944444444444444475e-01
1.759259259259259300e-01
1.851851851851851749e-01
1.759259259259259300e-01
2.129629629629629650e-01
2.592592592592592449e-01
2.222222222222222099e-01
2.129629629629629650e-01
2.037037037037036924e-01
2.037037037037036924e-01
2.592592592592592449e-01
1.018518518518518462e-01
1.111111111111111049e-01
1.574074074074074125e-01
2.314814814814814825e-01
2.314814814814814825e-01
3.518518518518518601e-01
2.685185185185185452e-01
2.129629629629629650e-01
2.500000000000000000e-01
2.222222222222222099e-01
2.500000000000000000e-01
2.870370370370370350e-01
1.203703703703703637e-01
1.111111111111111049e-01
1.018518518518518462e-01
1.203703703703703637e-01
2.962962962962962798e-01
1.851851851851851749e-01
3.055555555555555802e-01
3.518518518518518601e-01
2.314814814814814825e-01
2.500000000000000000e-01
2.037037037037036924e-01
1.944444444444444475e-01
1.481481481481481399e-01
1.851851851851851749e-01
2.592592592592592449e-01
2.592592592592592449e-01
1.851851851851851749e-01
1.388888888888888951e-01
1.203703703703703637e-01
2.129629629629629650e-01
1.666666666666666574e-01
1.574074074074074125e-01
1.574074074074074125e-01
1.481481481481481399e-01
1.388888888888888951e-01
1.388888888888888951e-01
1.481481481481481399e-01
1.388888888888888951e-01
2.685185185185185452e-01
2.870370370370370350e-01
1.666666666666666574e-01
2.129629629629629650e-01
1.388888888888888951e-01
2.222222222222222099e-01
1.666666666666666574e-01
2.037037037037036924e-01
2.222222222222222099e-01
1.296296296296296224e-01
1.111111111111111049e-01
2.222222222222222099e-01
1.203703703703703637e-01
1.203703703703703637e-01
1.018518518518518462e-01
7.407407407407406996e-02
1.574074074074074125e-01
1.388888888888888951e-01
2.222222222222222099e-01
1.111111111111111049e-01
1.203703703703703637e-01
1.203703703703703637e-01
1.574074074074074125e-01
1.666666666666666574e-01
1.666666666666666574e-01
1.944444444444444475e-01
1.759259259259259300e-01
1.666666666666666574e-01
1.574074074074074125e-01
1.296296296296296224e-01
1.296296296296296224e-01
2.037037037037036924e-01
2.870370370370370350e-01
2.592592592592592449e-01
1.851851851851851749e-01
1.018518518518518462e-01
1.018518518518518462e-01
1.296296296296296224e-01
1.296296296296296224e-01
1.018518518518518462e-01
1.203703703703703637e-01
1.203703703703703637e-01
1.574074074074074125e-01
2.592592592592592449e-01
2.500000000000000000e-01
1.851851851851851749e-01
2.129629629629629650e-01
1.944444444444444475e-01
1.851851851851851749e-01
1.018518518518518462e-01
2.592592592592592449e-01
1.944444444444444475e-01
2.222222222222222099e-01
2.129629629629629650e-01
2.592592592592592449e-01
3.518518518518518601e-01
3.611111111111111049e-01
2.592592592592592449e-01
1.018518518518518462e-01
1.851851851851851749e-01
3.333333333333333148e-01
1.481481481481481399e-01
2.314814814814814825e-01
1.759259259259259300e-01
2.500000000000000000e-01
2.314814814814814825e-01
2.037037037037036924e-01
3.055555555555555802e-01
1.574074074074074125e-01
2.777777777777777901e-01
2.314814814814814825e-01
3.425925925925926152e-01
2.592592592592592449e-01
1.759259259259259300e-01
3.703703703703703498e-01
3.240740740740740700e-01
2.870370370370370350e-01
2.314814814814814825e-01
2.314814814814814825e-01
1.296296296296296224e-01
2.222222222222222099e-01
2.777777777777777901e-01
1.574074074074074125e-01
1.203703703703703637e-01
2.685185185185185452e-01
2.962962962962962798e-01
3.148148148148148251e-01
2.407407407407407274e-01
1.759259259259259300e-01
1.851851851851851749e-01
2.129629629629629650e-01
1.574074074074074125e-01
2.129629629629629650e-01
2.777777777777777901e-01
1.388888888888888951e-01
1.388888888888888951e-01
1.111111111111111049e-01
2.037037037037036924e-01
1.111111111111111049e-01
5.555555555555555247e-02
1.203703703703703637e-01
1.111111111111111049e-01
1.574074074074074125e-01
1.388888888888888951e-01
1.759259259259259300e-01
8.333333333333332871e-02
1.388888888888888951e-01
1.388888888888888951e-01
1.296296296296296224e-01
1.296296296296296224e-01
2.500000000000000000e-01
1.481481481481481399e-01
1.296296296296296224e-01
1.296296296296296224e-01
7.407407407407406996e-02
1.111111111111111049e-01
1.851851851851851749e-01
1.111111111111111049e-01
1.203703703703703637e-01
1.111111111111111049e-01
1.111111111111111049e-01
1.296296296296296224e-01
1.388888888888888951e-01
8.333333333333332871e-02
1.296296296296296224e-01
2.314814814814814825e-01
1.018518518518518462e-01
1.666666666666666574e-01
1.851851851851851749e-01
1.481481481481481399e-01
1.018518518518518462e-01
2.314814814814814825e-01
2.500000000000000000e-01
1.388888888888888951e-01
1.018518518518518462e-01
1.296296296296296224e-01
1.018518518518518462e-01
1.481481481481481399e-01
1.759259259259259300e-01
2.314814814814814825e-01
1.666666666666666574e-01
1.388888888888888951e-01
1.203703703703703637e-01
1.481481481481481399e-01
1.203703703703703637e-01
1.203703703703703637e-01
1.388888888888888951e-01
2.685185185185185452e-01
2.222222222222222099e-01
1.666666666666666574e-01
2.407407407407407274e-01
1.111111111111111049e-01
1.111111111111111049e-01
1.203703703703703637e-01
2.129629629629629650e-01
2.314814814814814825e-01
2.314814814814814825e-01
1.851851851851851749e-01
1.944444444444444475e-01
1.944444444444444475e-01
1.851851851851851749e-01
1.574074074074074125e-01
1.203703703703703637e-01
1.111111111111111049e-01
1.203703703703703637e-01
1.388888888888888951e-01
1.851851851851851749e-01
1.203703703703703637e-01
1.388888888888888951e-01
1.574074074074074125e-01
6.481481481481481122e-02
1.296296296296296224e-01
1.481481481481481399e-01
1.759259259259259300e-01
1.111111111111111049e-01
3.055555555555555802e-01
3.611111111111111049e-01
2.407407407407407274e-01
1.296296296296296224e-01
1.203703703703703637e-01
1.666666666666666574e-01
1.666666666666666574e-01
1.203703703703703637e-01
5.555555555555555247e-02
1.203703703703703637e-01
1.296296296296296224e-01
8.333333333333332871e-02
0.000000000000000000e+00
1.203703703703703637e-01
1.388888888888888951e-01
1.388888888888888951e-01
1.574074074074074125e-01
1.018518518518518462e-01
1.111111111111111049e-01
2.314814814814814825e-01
1.851851851851851749e-01
1.666666666666666574e-01
1.481481481481481399e-01
1.388888888888888951e-01
1.759259259259259300e-01
1.481481481481481399e-01
1.481481481481481399e-01
2.222222222222222099e-01
1.851851851851851749e-01
1.574074074074074125e-01
1.388888888888888951e-01
1.944444444444444475e-01
2.129629629629629650e-01
1.388888888888888951e-01
