1.394967177528586844e-01
1.265932417299986679e-01
1.306450676796831467e-01
1.179118474495714636e-01
1.394967177528586844e-01
1.525312305750312902e-01
2.133791809916016635e-01
2.118787120950668124e-01
1.564551422293105620e-01
1.499770240526725751e-01
1.080523861682027298e-01
1.223919481204200632e-01
1.357062483886705140e-01
1.821728291127920063e-01
1.306450676796831467e-01
1.394967177528586844e-01
1.766176930264976852e-01
1.859106361431256682e-01
2.161222256930794561e-01
2.602766489426704410e-01
2.707419818608024498e-01
2.410909659244798442e-01
2.264404612964252828e-01
2.447671147209901366e-01
2.549234135644105059e-01
3.630952069331905840e-01
3.662058530531749900e-01
3.433625091153797992e-01
3.560962531632256844e-01
3.221970407397796721e-01
2.282561793809885220e-01
1.859106361431256682e-01
1.116565479306396991e-01
1.179118474495714636e-01
1.223919481204200632e-01
1.223919481204200632e-01
1.525312305750312902e-01
1.223919481204200632e-01
1.420268052176993367e-01
2.322991559838458731e-01
2.586745858057475922e-01
2.374960925265316991e-01
1.995415233485449691e-01
1.747421069058291143e-01
2.693271959839615426e-01
1.179118474495714636e-01
1.080523861682027298e-01
1.179118474495714636e-01
1.080523861682027298e-01
1.624168267244839314e-01
1.698065466513591915e-01
1.265932417299986679e-01
1.564551422293105620e-01
1.394967177528586844e-01
1.681775554834891162e-01
1.394967177528586844e-01
1.357062483886705140e-01
1.420268052176993367e-01
1.306450676796831467e-01
1.525312305750312902e-01
1.357062483886705140e-01
1.499770240526725751e-01
1.306450676796831467e-01
1.357062483886705140e-01
1.357062483886705140e-01
1.223919481204200632e-01
1.306450676796831467e-01
1.802125236673342290e-01
1.969425541862986906e-01
1.730228196598093682e-01
1.080523861682027298e-01
1.592685214103134461e-01
1.969425541862986906e-01
1.982420387674218298e-01
1.922085026545552189e-01
1.306450676796831467e-01
1.179118474495714636e-01
1.265932417299986679e-01
1.459748827731977838e-01
1.306450676796831467e-01
1.357062483886705140e-01
1.969425541862986906e-01
1.223919481204200632e-01
1.459748827731977838e-01
1.525312305750312902e-01
1.900593935266959855e-01
2.075648640175291049e-01
1.969425541862986906e-01
1.116565479306396991e-01
8.236827480644691446e-02
7.387032219466665994e-02
1.223919481204200632e-01
1.306450676796831467e-01
1.022180759584314091e-01
1.022180759584314091e-01
1.223919481204200632e-01
1.265932417299986679e-01
1.459748827731977838e-01
1.459748827731977838e-01
1.525312305750312902e-01
1.900593935266959855e-01
1.995415233485449691e-01
1.698065466513591915e-01
1.080523861682027298e-01
1.357062483886705140e-01
1.564551422293105620e-01
1.730228196598093682e-01
1.698065466513591915e-01
2.118787120950668124e-01
2.075648640175291049e-01
1.459748827731977838e-01
1.499770240526725751e-01
1.730228196598093682e-01
1.821728291127920063e-01
1.841200375091719688e-01
1.652474255660057456e-01
1.564551422293105620e-01
2.410909659244798442e-01
2.389809315387276811e-01
2.161222256930794561e-01
2.133791809916016635e-01
2.192872772717076868e-01
2.133791809916016635e-01
1.922085026545552189e-01
2.209284151272926655e-01
1.265932417299986679e-01
2.819193497981615781e-01
2.410909659244798442e-01
2.209284151272926655e-01
2.447671147209901366e-01
1.841200375091719688e-01
1.969425541862986906e-01
2.177047514823935437e-01
2.778607377282832913e-01
2.177047514823935437e-01
3.150007814920755544e-01
2.792867302259432472e-01
2.750087527329633241e-01
2.778607377282832913e-01
1.900593935266959855e-01
2.322991559838458731e-01
2.932238440096212595e-01
3.127735229737816924e-01
3.498749609232567614e-01
2.903657393200699266e-01
3.638728684631866162e-01
3.183416692695164585e-01
3.221970407397796721e-01
2.891591122455115515e-01
3.537632685732373106e-01
3.183416692695164585e-01
2.374960925265316991e-01
2.721567677376434125e-01
2.530478274437418795e-01
2.282561793809885220e-01
1.945210150959502948e-01
1.922085026545552189e-01
1.420268052176993367e-01
1.564551422293105620e-01
1.022180759584314091e-01
1.022180759584314091e-01
1.306450676796831467e-01
2.177047514823935437e-01
2.463332291317484046e-01
2.478993435425065894e-01
2.133791809916016635e-01
2.177047514823935437e-01
1.022180759584314091e-01
1.394967177528586844e-01
1.357062483886705140e-01
1.179118474495714636e-01
7.387032219466665994e-02
8.236827480644691446e-02
8.926695845542124974e-02
1.116565479306396991e-01
1.022180759584314091e-01
1.116565479306396991e-01
1.022180759584314091e-01
1.859106361431256682e-01
1.730228196598093682e-01
1.357062483886705140e-01
2.410909659244798442e-01
2.133791809916016635e-01
1.766176930264976852e-01
1.730228196598093682e-01
1.394967177528586844e-01
1.179118474495714636e-01
1.022180759584314091e-01
1.394967177528586844e-01
7.387032219466665994e-02
8.236827480644691446e-02
8.236827480644691446e-02
1.179118474495714636e-01
1.116565479306396991e-01
1.698065466513591915e-01
1.116565479306396991e-01
1.306450676796831467e-01
1.223919481204200632e-01
9.510690389870302131e-02
1.022180759584314091e-01
1.179118474495714636e-01
1.394967177528586844e-01
1.681775554834891162e-01
1.945210150959502948e-01
1.022180759584314091e-01
1.080523861682027298e-01
1.306450676796831467e-01
1.394967177528586844e-01
1.420268052176993367e-01
1.499770240526725751e-01
1.592685214103134461e-01
1.116565479306396991e-01
1.116565479306396991e-01
1.116565479306396991e-01
8.926695845542124974e-02
9.510690389870302131e-02
7.387032219466665994e-02
8.926695845542124974e-02
1.080523861682027298e-01
1.080523861682027298e-01
7.387032219466665994e-02
5.470459518304063296e-02
3.258830884427191266e-02
2.172553922951458993e-02
5.095342294170348424e-02
2.172553922951458993e-02
2.172553922951458993e-02
8.236827480644691446e-02
1.747421069058291143e-01
1.982420387674218298e-01
9.510690389870302131e-02
8.926695845542124974e-02
1.116565479306396991e-01
1.394967177528586844e-01
1.420268052176993367e-01
1.525312305750312902e-01
1.080523861682027298e-01
1.265932417299986679e-01
1.841200375091719688e-01
1.525312305750312902e-01
7.387032219466665994e-02
8.926695845542124974e-02
1.306450676796831467e-01
1.265932417299986679e-01
1.652474255660057456e-01
1.652474255660057456e-01
2.075648640175291049e-01
2.118787120950668124e-01
2.118787120950668124e-01
2.251501585252427273e-01
1.592685214103134461e-01
1.766176930264976852e-01
1.900593935266959855e-01
1.900593935266959855e-01
1.802125236673342290e-01
1.730228196598093682e-01
1.394967177528586844e-01
1.080523861682027298e-01
1.022180759584314091e-01
5.095342294170348424e-02
6.845889343253658277e-02
6.236271754192673072e-02
8.236827480644691446e-02
1.179118474495714636e-01
1.394967177528586844e-01
1.420268052176993367e-01
1.357062483886705140e-01
1.766176930264976852e-01
1.821728291127920063e-01
9.510690389870302131e-02
