1.394967177528586844e-01
1.564551422293105620e-01
1.766176930264976852e-01
1.859106361431256682e-01
1.624168267244839314e-01
1.995415233485449691e-01
3.910910220130502934e-01
2.264404612964252828e-01
1.922085026545552189e-01
1.420268052176993367e-01
1.652474255660057456e-01
1.698065466513591915e-01
1.681775554834891162e-01
1.841200375091719688e-01
1.265932417299986679e-01
1.747421069058291143e-01
1.652474255660057456e-01
1.624168267244839314e-01
1.681775554834891162e-01
1.420268052176993367e-01
1.525312305750312902e-01
1.394967177528586844e-01
1.080523861682027298e-01
1.624168267244839314e-01
2.061829087189939735e-01
2.192872772717076868e-01
2.432010003102319518e-01
2.300718974655519555e-01
2.209284151272926655e-01
2.360112535143357448e-01
2.513316661433301347e-01
2.922711424464374819e-01
3.433625091153797992e-01
2.300718974655519555e-01
1.420268052176993367e-01
1.022180759584314091e-01
1.179118474495714636e-01
1.821728291127920063e-01
1.525312305750312902e-01
2.463332291317484046e-01
2.586745858057475922e-01
2.819193497981615781e-01
1.592685214103134461e-01
1.730228196598093682e-01
1.730228196598093682e-01
1.624168267244839314e-01
1.698065466513591915e-01
2.133791809916016635e-01
2.264404612964252828e-01
2.707419818608024498e-01
1.116565479306396991e-01
1.420268052176993367e-01
1.564551422293105620e-01
1.306450676796831467e-01
1.624168267244839314e-01
1.499770240526725751e-01
1.730228196598093682e-01
1.420268052176993367e-01
1.420268052176993367e-01
1.499770240526725751e-01
1.116565479306396991e-01
1.802125236673342290e-01
2.048009534204588422e-01
1.681775554834891162e-01
1.306450676796831467e-01
1.499770240526725751e-01
1.747421069058291143e-01
1.922085026545552189e-01
2.020491522450830468e-01
1.116565479306396991e-01
1.747421069058291143e-01
2.602766489426704410e-01
1.900593935266959855e-01
1.821728291127920063e-01
2.879524851709532318e-01
1.080523861682027298e-01
1.080523861682027298e-01
1.116565479306396991e-01
1.420268052176993367e-01
1.459748827731977838e-01
1.394967177528586844e-01
1.394967177528586844e-01
1.459748827731977838e-01
1.681775554834891162e-01
1.592685214103134461e-01
1.564551422293105620e-01
1.624168267244839314e-01
1.499770240526725751e-01
1.592685214103134461e-01
1.698065466513591915e-01
1.306450676796831467e-01
1.394967177528586844e-01
1.652474255660057456e-01
1.821728291127920063e-01
1.821728291127920063e-01
1.821728291127920063e-01
1.681775554834891162e-01
2.020491522450830468e-01
2.133791809916016635e-01
2.177047514823935437e-01
1.499770240526725751e-01
1.459748827731977838e-01
1.564551422293105620e-01
1.499770240526725751e-01
1.766176930264976852e-01
1.821728291127920063e-01
1.821728291127920063e-01
1.995415233485449691e-01
1.698065466513591915e-01
1.624168267244839314e-01
1.459748827731977838e-01
2.602766489426704410e-01
2.549234135644105059e-01
2.530478274437418795e-01
2.735827602353033683e-01
2.282561793809885220e-01
2.061829087189939735e-01
2.075648640175291049e-01
2.192872772717076868e-01
1.564551422293105620e-01
1.420268052176993367e-01
1.592685214103134461e-01
2.251501585252427273e-01
2.879524851709532318e-01
2.103782431985319612e-01
1.624168267244839314e-01
1.841200375091719688e-01
1.747421069058291143e-01
1.841200375091719688e-01
1.841200375091719688e-01
1.945210150959502948e-01
1.841200375091719688e-01
2.133791809916016635e-01
2.300718974655519555e-01
2.707419818608024498e-01
2.389809315387276811e-01
2.567989996850790213e-01
2.922711424464374819e-01
2.664976242302797282e-01
2.735827602353033683e-01
2.118787120950668124e-01
2.960819486991725924e-01
2.586745858057475922e-01
3.553185916332294858e-01
3.506526224532529046e-01
2.913184408832537597e-01
2.941765455728049816e-01
2.970346502623563145e-01
3.083190059371938019e-01
1.698065466513591915e-01
1.652474255660057456e-01
1.652474255660057456e-01
1.525312305750312902e-01
1.821728291127920063e-01
1.730228196598093682e-01
1.995415233485449691e-01
1.878712097505091383e-01
7.387032219466665994e-02
1.179118474495714636e-01
1.922085026545552189e-01
1.652474255660057456e-01
1.499770240526725751e-01
1.022180759584314091e-01
1.116565479306396991e-01
1.223919481204200632e-01
1.223919481204200632e-01
9.510690389870302131e-02
1.080523861682027298e-01
1.265932417299986679e-01
1.995415233485449691e-01
2.075648640175291049e-01
1.766176930264976852e-01
1.459748827731977838e-01
2.300718974655519555e-01
2.389809315387276811e-01
1.265932417299986679e-01
1.179118474495714636e-01
1.499770240526725751e-01
1.525312305750312902e-01
1.652474255660057456e-01
1.859106361431256682e-01
1.982420387674218298e-01
1.223919481204200632e-01
9.510690389870302131e-02
9.510690389870302131e-02
1.022180759584314091e-01
1.394967177528586844e-01
1.420268052176993367e-01
1.459748827731977838e-01
1.499770240526725751e-01
1.116565479306396991e-01
1.179118474495714636e-01
1.022180759584314091e-01
1.459748827731977838e-01
1.420268052176993367e-01
1.265932417299986679e-01
1.022180759584314091e-01
8.926695845542124974e-02
9.510690389870302131e-02
1.179118474495714636e-01
2.172553922951458993e-02
2.172553922951458993e-02
1.080523861682027298e-01
4.345107845902922150e-02
6.236271754192673072e-02
1.223919481204200632e-01
1.394967177528586844e-01
1.525312305750312902e-01
1.859106361431256682e-01
1.766176930264976852e-01
1.459748827731977838e-01
1.499770240526725751e-01
1.525312305750312902e-01
8.926695845542124974e-02
9.510690389870302131e-02
1.306450676796831467e-01
1.223919481204200632e-01
1.306450676796831467e-01
1.306450676796831467e-01
1.357062483886705140e-01
1.306450676796831467e-01
1.265932417299986679e-01
1.652474255660057456e-01
1.022180759584314091e-01
8.926695845542124974e-02
1.179118474495714636e-01
1.116565479306396991e-01
1.564551422293105620e-01
1.525312305750312902e-01
1.681775554834891162e-01
1.766176930264976852e-01
1.080523861682027298e-01
1.116565479306396991e-01
1.394967177528586844e-01
1.459748827731977838e-01
1.564551422293105620e-01
1.982420387674218298e-01
2.020491522450830468e-01
1.922085026545552189e-01
1.698065466513591915e-01
1.652474255660057456e-01
1.730228196598093682e-01
2.048009534204588422e-01
1.499770240526725751e-01
8.236827480644691446e-02
8.926695845542124974e-02
5.095342294170348424e-02
2.172553922951458993e-02
6.845889343253658277e-02
4.720225070036634940e-02
4.345107845902922150e-02
4.345107845902922150e-02
1.022180759584314091e-01
1.022180759584314091e-01
8.926695845542124974e-02
8.236827480644691446e-02
1.116565479306396991e-01
9.510690389870302131e-02
1.022180759584314091e-01
1.080523861682027298e-01
1.265932417299986679e-01
1.223919481204200632e-01
1.223919481204200632e-01
1.223919481204200632e-01
1.394967177528586844e-01
1.306450676796831467e-01
1.766176930264976852e-01
1.652474255660057456e-01
1.459748827731977838e-01
9.510690389870302131e-02
